NO ./assets/NO.xpm
SO ./assets/SO.xpm
WE ./assets/WE.xpm
EA ./assets/EA.xpm
F 234,123,0
C 135,5,224


111111111111111111111111111111111111111111111111111111
100000000000000000000000000000000000000000000000010001
10000000000000000000000000000000000000000000111111111
100000000000000000000000000000000000000000001
100000000000000000000000000000000000000000001
10000000000000000000000000000000000000000001
100000000000000000000000000000000000000000001
100000000000000000000000000000000000000000001
100000000000000000000000000000000000000000001
100000000000000000000000000000000000000000001
1000000000000000000111110000000000000000000001
100000000000000000000000000000000000000000001
10000000000000000000000N000000000000000000001
100000000000000000000000000000000000000000001
100000000000000000000000000000000000000000001
100000000000000000000000000000000000000000001
100000000000000000000000000000000000000000001
111111111111111111111111111111111111111111111