1111111111111111111111111111111111
1EC000000CCC000000000000000C00C001
10100101C010CC001010010000C0C10101
101001001C1C10100C1001000000010101
100PCCC000C0000000000000000C000001
100C0C000C0000000000000000C0000001
1111111111111111111111111111111111