1111111111111
1000000C00E01
1C00000000001
10000P0100001
1111111111111